# MUST BE IN THIS ORDER
# tileset file name
# map w x h
# tile w x h

tileset tileset1.png
mapsize 60 34
tilesize 32 32

0	0	132	133	0	0	0	0	0	0	0	0	0	0	36	37	0	0	0	0	0	0	132	133	0	0	0	0	0	0	0	0	0	0	36	37	0	0	0	0	0	0	132	133	0	0	0	0	0	0	0	0	0	0	36	37	0	0	0	0
0	0	0	0	0	0	0	0	0	0	0	0	0	0	0	0	0	0	0	0	0	0	0	0	0	0	0	0	0	0	0	0	0	0	0	0	0	0	0	0	0	0	0	0	0	0	0	0	0	0	0	0	0	0	0	0	0	0	0	0
0	0	0	0	0	52	0	0	0	0	0	0	0	0	0	0	0	0	0	0	0	0	0	0	0	52	0	0	0	0	0	0	0	0	0	0	0	0	0	0	0	0	0	0	0	52	0	0	0	0	0	0	0	0	0	0	0	0	0	0
0	0	0	0	0	0	0	0	0	0	0	0	0	0	0	0	0	0	0	0	0	0	0	0	0	0	0	0	0	0	0	0	0	0	0	0	0	0	0	0	0	0	0	0	0	0	0	0	0	0	0	0	0	0	0	0	0	0	0	0	
0	0	0	0	0	0	0	0	0	0	0	0	0	0	0	0	0	0	0	0	0	0	0	0	0	0	0	0	0	0	0	0	0	0	0	0	0	0	0	0	0	0	0	0	0	0	0	0	0	0	0	0	0	0	0	0	0	0	0	0
0	0	0	0	0	0	0	0	0	0	0	0	0	0	0	0	0	0	0	0	0	0	0	0	0	0	0	0	0	0	0	0	0	0	0	0	0	0	0	0	0	0	0	0	0	0	0	0	0	0	0	0	0	0	0	0	0	0	0	0
0	0	0	0	0	0	0	0	0	98	0	0	0	0	0	48	0	0	0	0	0	0	0	0	0	0	0	0	0	98	0	0	0	0	0	48	0	0	0	0	0	0	0	0	0	0	0	0	0	98	0	0	0	0	0	48	0	0	0	0
0	0	18	19	0	0	0	0	0	0	0	0	0	0	0	0	0	0	0	0	0	0	18	19	0	0	0	0	0	0	0	0	0	0	0	0	0	0	0	0	0	0	18	19	0	0	0	0	0	0	0	0	0	0	0	0	0	0	0	0
0	0	34	35	0	0	0	0	0	0	0	0	0	0	18	3	3	3	19	0	0	0	34	35	0	0	0	0	0	0	0	0	0	0	18	3	3	3	19	0	0	0	34	35	0	0	0	0	0	0	0	0	0	0	18	3	3	3	19	0
0	0	0	0	0	0	0	0	0	0	0	0	0	18	19	116	117	0	19	0	0	0	0	0	0	0	0	0	0	0	0	0	0	18	19	116	117	0	19	0	0	0	0	0	0	0	0	0	0	0	0	0	0	18	19	116	117	0	19	0
0	0	0	0	48	0	0	0	0	0	0	0	18	19	116	101	101	117	19	0	0	0	0	0	48	0	0	0	0	0	0	0	18	19	116	101	101	117	19	0	0	0	0	0	48	0	0	0	0	0	0	0	18	19	116	101	101	117	19	0
0	0	0	0	0	0	0	66	67	0	0	0	18	116	101	101	101	133	19	0	0	0	0	0	0	0	0	66	67	0	0	0	18	116	101	101	101	133	19	0	0	0	0	0	0	0	0	66	67	0	0	0	18	116	101	101	101	133	19	0
0	0	0	0	0	0	0	82	83	0	0	0	18	132	101	101	101	18	19	0	0	0	0	0	0	0	0	82	83	0	0	0	18	132	101	101	101	18	19	0	0	0	0	0	0	0	0	82	83	0	0	0	18	132	101	101	101	18	19	0
0	0	0	0	0	0	0	0	0	0	0	0	34	3	3	3	3	35	100	0	0	0	0	0	0	0	0	0	0	0	0	0	34	3	3	3	3	35	100	0	0	0	0	0	0	0	0	0	0	0	0	0	34	3	3	3	3	35	100	0
0	0	98	0	0	0	0	0	0	0	0	0	0	0	0	0	0	0	0	0	0	0	98	0	0	0	0	0	0	0	0	0	0	0	0	0	0	0	0	0	0	0	98	0	0	0	0	0	0	0	0	0	0	0	0	0	0	0	0	0
0	0	0	0	0	0	0	0	0	0	0	0	0	0	0	0	0	0	0	0	0	0	0	0	0	0	0	0	0	0	0	0	0	0	0	0	0	0	0	0	0	0	0	0	0	0	0	0	0	0	0	0	0	0	0	0	0	0	0	0	
0	66	51	51	67	0	0	0	0	0	0	0	0	0	0	0	0	0	0	0	0	66	51	51	67	0	0	0	0	0	0	0	0	0	0	0	0	0	0	0	0	66	51	51	67	0	0	0	0	0	0	0	0	0	0	0	0	0	0	0
0	51	64	65	51	0	0	0	0	0	0	0	98	0	0	0	0	0	0	0	0	51	64	65	51	0	0	0	0	0	0	0	98	0	0	0	0	0	0	0	0	51	64	65	51	0	0	0	0	0	0	0	98	0	0	0	0	0	0	0
0	51	80	81	51	0	0	0	0	114	115	0	0	0	0	0	0	0	0	0	0	51	80	81	51	0	0	0	0	114	115	0	0	0	0	0	0	0	0	0	0	51	80	81	51	0	0	0	0	114	115	0	0	0	0	0	0	0	0	0
0	82	51	51	83	0	0	0	68	130	131	0	0	0	0	0	0	0	0	0	0	82	51	51	83	0	0	0	68	130	131	0	0	0	0	0	0	0	0	0	0	82	51	51	83	0	0	0	68	130	131	0	0	0	0	0	0	0	0	0
0	0	0	0	0	0	0	0	84	85	50	0	0	0	0	0	0	0	0	0	0	0	0	0	0	0	0	0	84	85	50	0	0	0	0	0	0	0	0	0	0	0	0	0	0	0	0	0	84	85	50	0	0	0	0	0	0	0	0	0
0	0	0	0	0	0	0	0	0	0	0	0	0	0	0	0	0	0	0	0	0	0	0	0	0	0	0	0	0	0	0	0	0	0	0	0	0	0	0	0	0	0	0	0	0	0	0	0	0	0	0	0	0	0	0	0	0	0	0	0
0	0	0	0	0	0	0	0	0	98	0	0	0	0	0	48	0	0	0	0	0	0	0	0	0	0	0	0	0	98	0	0	0	0	0	48	0	0	0	0	0	0	0	0	0	0	0	0	0	98	0	0	0	0	0	48	0	0	0	0
0	0	18	19	0	0	0	0	0	0	0	0	0	0	0	0	0	0	0	0	0	0	18	19	0	0	0	0	0	0	0	0	0	0	0	0	0	0	0	0	0	0	18	19	0	0	0	0	0	0	0	0	0	0	0	0	0	0	0	0
0	0	34	35	0	0	0	0	0	0	0	0	0	0	18	3	3	3	19	0	0	0	34	35	0	0	0	0	0	0	0	0	0	0	18	3	3	3	19	0	0	0	34	35	0	0	0	0	0	0	0	0	0	0	18	3	3	3	19	0
0	0	0	0	0	0	0	0	0	0	0	0	0	18	19	116	117	0	19	0	0	0	0	0	0	0	0	0	0	0	0	0	0	18	19	116	117	0	19	0	0	0	0	0	0	0	0	0	0	0	0	0	0	18	19	116	117	0	19	0
0	0	0	0	48	0	0	0	0	0	0	0	18	19	116	101	101	117	19	0	0	0	0	0	48	0	0	0	0	0	0	0	18	19	116	101	101	117	19	0	0	0	0	0	48	0	0	0	0	0	0	0	18	19	116	101	101	117	19	0
0	0	0	0	0	0	0	66	67	0	0	0	18	116	101	101	101	133	19	0	0	0	0	0	0	0	0	66	67	0	0	0	18	116	101	101	101	133	19	0	0	0	0	0	0	0	0	66	67	0	0	0	18	116	101	101	101	133	19	0
0	0	0	0	0	0	0	82	83	0	0	0	18	132	101	101	101	18	19	0	0	0	0	0	0	0	0	82	83	0	0	0	18	132	101	101	101	18	19	0	0	0	0	0	0	0	0	82	83	0	0	0	18	132	101	101	101	18	19	0
0	0	0	0	0	0	0	0	0	0	0	0	34	3	3	3	3	35	100	0	0	0	0	0	0	0	0	0	0	0	0	0	34	3	3	3	3	35	100	0	0	0	0	0	0	0	0	0	0	0	0	0	34	3	3	3	3	35	100	0
0	0	98	0	0	0	0	0	0	0	0	0	0	0	0	0	0	0	0	0	0	0	98	0	0	0	0	0	0	0	0	0	0	0	0	0	0	0	0	0	0	0	98	0	0	0	0	0	0	0	0	0	0	0	0	0	0	0	0	0
0	0	0	0	0	0	0	0	0	0	0	0	0	0	0	0	0	100	0	0	0	0	0	0	0	0	0	0	0	0	0	0	0	0	0	0	0	100	0	0	0	0	0	0	0	0	0	0	0	0	0	0	0	0	0	0	0	100	0	0
0	0	0	0	0	0	0	0	53	0	0	0	0	0	0	0	0	0	0	0	0	0	0	0	0	0	0	0	53	0	0	0	0	0	0	0	0	0	0	0	0	0	0	0	0	0	0	0	53	0	0	0	0	0	0	0	0	0	0	0
0	0	116	117	0	0	0	0	0	0	0	0	0	0	20	21	0	0	0	0	0	0	116	117	0	0	0	0	0	0	0	0	0	0	20	21	0	0	0	0	0	0	116	117	0	0	0	0	0	0	0	0	0	0	20	21	0	0	0	0